****************************....****************************
*..........................................................*
*..........................................................*
*..........................................................*
*..........................................................*
*..........................................................*
*..........................................................*
*..........................................................*
*..........................................................*
*..........................................................*
*..........................................................*
*..........................................................*
*..........................................................*
*..........................................................*
*..........................................................*
*..........................................................*
*..........................................................*
*..........................................................*
*..........................................................*
*..........................................................*
*..........................................................*
*..........................................................*
*..........................................................*
*..........................................................*
*..........................................................*
*..........................................................*
*..........................................................*
*..........................................................*
*..........................................................*
*..........................................................*
*..........................................................*
*..........................................................*
*..........................................................*
*..........................................................*
*..........................................................*
*..........................................................*
*..........................................................*
*..........................................................*
*..........................................................*
************************************************************