****************************....****************************
*..........................................................*
*..........................................................*
*..........................................................*
*..........................................................*
*..........................................................*
*..........................................................*
*..........................................................*
*..........................................................*
*..........................................................*
*..........................................................*
*..........................................................*
*..........................................................*
*..........................................................*
*..........................................................*
*..........................................................*
*..........................................................*
*..........................................................*
*...........................*.*............................*
*..........................................................*
*..........................................................*
*..........................................................*
*..........................................................*
*..........................................................*
*..........................................................*
*..........................................................*
*..........................................................*
*..........................................................*
*..........................................................*
*..........................................................*
*..........................................................*
*..........................................................*
*..........................................................*
*..........................................................*
*..........................................................*
*..........................................................*
*..........................................................*
*..........................................................*
*..........................................................*
****************************....****************************